                                                                      
                                                                      
              #############################                           
              #                           #                           
  ###################################################                 
  #                #          #               #               #       
  #                #          #               #               #       
  #         #######z###########               #               #       
  #                #          ##################              #       
  #                #          #       #      #                #       
  $                           #       #      #         ########       
       ########################       ##     #         ###    #       
                              #       #      #         ###    #       
                              #       #      #         ###    #       
           ####################       #      #############    #       
           #                          #      #                ##      
           ############################      #                 #      
           $                                 ###################      
                                                                      
                                                                      
